1111111111
1000000001
1001110001
1000011111
1000000001
1011100001
1010000001
1110000001
1000000111
1000100001
1010100001
1011100001
1010000X01
1010000001
1111111111
